XXXXXXXXXXXXXXXXXXXX
XFFFFFFFFFFFFXFFFFFX
XFXXXXFXXXXXFXFXXXFX
XFFFFFFFFFFFFFFFFFFX
XFXXXXFXXXXXXXXFXXFX
XFFFFFFFFFFXFFFFFFFX
XXXXXXFXXXFXFXXXXXFX
XFFFFFFFFFFXFFFFFFFX
XFXXXXXXXXXXXXXXXXFX
XFFFFFFFXFFFXFFFFFFX
XFXXXXXXXXFXXXXXXXFX
XFFFFFFFFFFFFXFFFFFX
XFXXXXFXXXXXFXFXXXFX
XFFFFFFFFFFFFFFFFFFX
XFXXXXFXXXXXXXXFXXFX
XFFFFFFFFFFXFFFFFFFX
XXXXXXFXXXFXFXXXXXFX
XFFFFFFFFFFXFFFFFFFX
XFXXXXXXXXXXXXXXXXFX
XXXXXXXXXXXXXXXXXXXX
