XXXXXXXXXXXXXXXXXXXX
XFFFFFFFFFFFFXFFFFFX
XFXXXXFXXXXXFXFXXXFX
XFFFFFFFFFFFFFFFFFFX
XFXXXXFXXXXXXXXFXXFX
XFFFFFFFFFFXFFFFFFFX
XXXXXXFXXXFXFXXXXXFX
XFFFFFFFFFFXFFFFFFFX
XFXXXXXXXXXXXXXXXXFX
XFFFFFFFXFFFXFFFFFFX
XFXXXXXXXXFXXXXXXXFX
XFFFFFFFFFFFFFFFFXFX
XFXXXXXFXFFXXXXXFXFX
XFXFFFXFXFFXFFFFFXFX
XFXFFFFFXFFXFXXXXXFX
XFXFFFFFXFFFFFFFFFFX
XFXFFFFFXXXXFFFFFFFX
XFXXXXXFFFFXXXXXXXFX
XFFFFFFFFFFFFFFFFFFX
XXXXXXXXXXXXXXXXXXXX